MMMMMMMMMMMMMMMMMMMMMMMMMMMMMMMMMMMMMMMMMM
MMMMMMMMMMMMMMMMMMMMMMMMMMMMMMMMMMMMMMMMMM
MMMMMMMMMMMMMMMMMMMMMMMMMMMMMMMMMMMMMMMMMM
MMMPPPPPPPPPPMPPPPRRPRPRPPPPPPMPPPPPPPPMMM
MMMPRRRPRPRPPQPPRPPPPRPRPRRRPPKPPPPPPEPMMM
MMMPPPPPRPRPPMPPRPRRPPPPPRPPPPMPPPPPPPPMMM
MMMPRRMMMMMMMMMMMMMMMMMMMMMMMMMMMMMMMMMMMM
MMMPRPMMMMMMMMMMMMMMMMMMMMMMMMMMMMMMMMMMMM
MMMPRPPRPPPPPPMPPPPPRPRPPPPMPPPPPRPPRPPMMM
MMMPRPPRPRRRPPJPPRPPRPRRRPP9PPRPPRPPRRPMMM
MMMPPPPPPPPRPPMPPRPPPPPPRPPMPPRPPPPPPPPMMM
MMMMMMMMMMMMMMMMMMMMMMMMMMMMMMMMMMMMPRPMMM
MMMMMMMMMMMMMMMMMMMMMMMMMMMMMMMMMMMMPPPMMM
MMMMMMMMMMMMMMMMMMMMMMMMMMMMMMMMMMMMM8MMMM
MMMMMMMMMMMMMMMMMMMMMMMMMMMMMMMMMMMMPPPMMM
MMMMMMMMMMMMMMMMMMMMMMMMMMMMMMMMMMMMPPPMMM
MMMPPPPRPMPPRPPPPPRPPPPPRPPPPMPPPPRRPRPMMM
MMMPPPPRP6PRRPPRPPRPRRPPRPRRP7PPRPPRPRPMMM
MMMRRPPPPMPPPPPRPPPPPRPPPPPPPMPPRPPPPPPMMM
MMMPPPMMMMMMMMMMMMMMMMMMMMMMMMMMMMMMMMMMMM
MMMRRPMMMMMMMMMMMMMMMMMMMMMMMMMMMMMMMMMMMM
MMMPPPMMMMMMMMMMMMMMMMMMMMMMMMMMMMMMMMMMMM
MMMPRMMMMMMMMMMMMMMMMMMMMMMMMMMMMMMMMMMMMM
MMMPRPPPPMPPPPPRPPPPPPPRPPMPPPRPPRPPPPPMMM
MMMPRRPRP5PPRRPRRRPRRRPRRP4PRPRRPRPRPPPMMM
MMMPPPPRPMPPPPPPPRPRPPPPPPMPPPPPPPPRRRPMMM
MMMMMMMMMMMMMMMMMMMMMMMMMMMMMMMMMMMMPPPMMM
MMMMMMMMMMMMMMMMMMMMMMMMMMMMMMMMMMMMRRPMMM
MMMMMMMMMMMMMMMMMMMMMMMMMMMMMMMMMMMMPPPMMM
MMMMMMMMMMMMMMMMMMMMMMMMMMMMMMMMMMMMRRPMMM
MMMPPPPRPPPPRPPPPMPPPPPPPRRRPPPRPMPRPRPMMM
MMMRRRPRPRPPRPRRP2PPRPRRPRPPPPPRP3PRPRPMMM
MMMPPPPPPRPPPPPPPMPPRPPPPRPPRRPPPMPPPPPMMM
MMMPRRMMMMMMMMMMMMMMMMMMMMMMMMMMMMMMMMMMMM
MMMPPPMMMMMMMMMMMMMMMMMMMMMMMMMMMMMMMMMMMM
MMMPRRMMMMMMMMMMMMMMMMMMMMMMMMMMMMMMMMMMMM
MMMPPRPPPPPPRPPPRPPRPMPPPPPPRPPPPPPPPPPMMM
MMMPPRRRPRPPRPPRRRPRP1PRPRRPRPRPPRPPPSPMMM
MMMPPPPPPRPPPPPPPPPRPMPRPPPPPPPPPRPPPPPMMM
MMMMMMMMMMMMMMMMMMMMMMMMMMMMMMMMMMMMMMMMMM
MMMMMMMMMMMMMMMMMMMMMMMMMMMMMMMMMMMMMMMMMM
MMMMMMMMMMMMMMMMMMMMMMMMMMMMMMMMMMMMMMMMMM